1111111111221111
11 13          1
11 12          1
11 1222222  2221
11             1
1              1
1              1
1              1
1111111111111111